111111111
10P000001
10110C001
1C0000001
100E00001
111111111