111111111
10P0X0X01
10110C001
1C0000X01
100E00001
111111111